Goofy Titles## Business / Economics ##Multiple Generations in the Grown-up SandboxThe True Impact of Celebrating Service AnniversariesGreat Salespeople: Nature or NurtureStop Hiring the Wrong EmployeesChecking for Fit When Hiring Top SalespeopleHow (and Why) to Welcome Millennial CandidatesWhy You Should Create an Engaging Careers WebsiteDoes Telecommuting Stifle Creative Collaboration?Reviewing the Performance ReviewBig Data, Social Business and the Future of HRCan Your Compensation Plan Tell Time?Six Pieces of Advice for RecruitersToday’s Tech Hiring TrendsFive Steps to Creating a Talent CommunityI’m Not a Supervisor — I Just Play One at Family DollarHealthcare Reform and the New Wave of PermatempsThe Top Seven Management Myths The Art of the Job DescriptionAre you Setting Up Your Salespeople for FailureProject Management Skills for the HR ExecutiveAre you Prepared for the Supertemp BoomThe Equilateral Triangle Model for Developing Sales Compensation PlansMaslow’s Hierarchy of Hiring PyramidThree Common Talent Acquisition MisconceptionsDo You Have Engaged Employees or SurvivalistsBoomerang Employees: Should You Rehire Employees Who Quit?Ethics on the Sales FloorMillennials and the World of WorkThe Shrinking Pipeline of Sales ProfessionalsMentoring: An Age-Old Idea That Works NowVideo Interviewing — The New FrontierOpening Your Arms To Online Degrees!
Freakonomics: A Rogue Economist Explores the Hidden Side of Everything
The Wealth of Nations: An Inquiry into the Nature & Causes of the Wealth of Nations
The Road to Serfdom
Economics in One Lesson: The Shortest and Surest Way to Understand Basic Economics 
The World Is Flat: A Brief History of the Twenty-First Century 
The Big Short: Inside the Doomsday Machine
The Undercover Economist
Predictably Irrational: The Hidden Forces That Shape Our Decisions
The Black Swan: The Impact of the Highly Improbable 
The Shock Doctrine: The Rise of Disaster Capitalism 
The Ascent of Money: A Financial History of the World 
Capitalism and Freedom
Confessions of an Economic Hit Man 
Basic Economics: A Citizen's Guide to the Economy
Naked Economics: Undressing the Dismal Science
Boomerang: Travels in the New Third World
The General Theory of Employment, Interest, and Money 
Fooled by Randomness: The Hidden Role of Chance in Life and in the Markets 
The Worldly Philosophers
Free to Choose: A Personal Statement
Small Is Beautiful: Economics as if People Mattered
Human Action: A Treatise on Economics
The Long Tail: Why the Future of Business is Selling Less of More 

## Sociology / Anthropology ##
The Tipping Point: How Little Things Can Make a Big Difference 
Nickel and Dimed: On (Not) Getting By in America 
Outliers: The Story of Success
Guns, Germs, and Steel: The Fates of Human Societies 
The Protestant Ethic and the Spirit of Capitalism
Bowling Alone: The Collapse and Revival of American Community
Collapse: How Societies Choose to Fail or Succeed
The Presentation of Self in Everyday Life
Quiet: The Power of Introverts in a World That Can't Stop Talking
On Suicide: A Study in Sociology
The Sociological Imagination
Discipline and Punish: The Birth of the Prison
The Communist Manifesto 
Gang Leader for a Day: A Rogue Sociologist Takes to the Streets 
The Social Construction of Reality: A Treatise in the Sociology of Knowledge
Amusing Ourselves to Death: Public Discourse in the Age of Show Business
What the Dog Saw and Other Adventures
The Omnivore's Dilemma: A Natural History of Four Meals 
The Beauty Myth: How Images of Beauty are Used Against Women
Stigma: Notes on the Management of Spoiled Identity 
Bright-Sided: How the Relentless Promotion of Positive Thinking Has Undermined America
Bait and Switch: The (Futile) Pursuit of the American Dream
The Death and Life of Great American Cities
Distinction: A Social Critique of the Judgement of Taste 
The Better Angels of Our Nature: Why Violence Has Declined 
No Logo: No Space, No Choice, No Jobs
Cinderella Ate My Daughter: Dispatches from the Front Lines of the New Girlie-Girl Culture
The Zombie Room 
The Elephant Tree 
The Elementary Forms of Religious Life
The Psychopath Test: A Journey Through the Madness Industry 
The Wisdom of Crowds 
Savage Inequalities: Children in America's Schools
The Culture of Fear: Why Americans Are Afraid of the Wrong Things 
Cows, Pigs, Wars, and Witches: The Riddles of Culture 
1491: New Revelations of the Americas Before Columbus 
The Spirit Catches You and You Fall Down: A Hmong Child, Her American Doctors, and the Collision of Two Cultures
Debt: The First 5,000 Years
Purity and Danger: An Analysis of Concepts of Pollution and Taboo
The World Until Yesterday: What Can We Learn from Traditional Societies?
Argonauts of the Western Pacific
Cannibals and Kings: Origins of Cultures
The Teachings of Don Juan: A Yaqui Way of Knowledge 
The Chrysanthemum and the Sword: Patterns of Japanese Culture 
In Search of Respect: Selling Crack in El Barrio
Fragments of an Anarchist Anthropology

## Travel ##
A Walk in the Woods: Rediscovering America on the Appalachian Trail
Eat, Pray, Love
Notes from a Small Island
Neither Here Nor There: Travels in Europe
The Lost Continent: Travels in Small Town America
I'm a Stranger Here Myself: Notes on Returning to America After 20 Years Away 
Under the Tuscan Sun
A Year in Provence
Into the Wild
1000 Places to See Before You Die
Travels with Charley: In Search of America
The Geography of Bliss: One Grump's Search for the Happiest Places in the World 
On the Road 
The Great Railway Bazaar 
The Art of Travel 
Vagabonding: An Uncommon Guide to the Art of Long-Term World Travel
Blue Highways
Tales of a Female Nomad: Living at Large in the World 
Wild: From Lost to Found on the Pacific Crest Trail 
Dark Star Safari: Overland from Cairo to Cape Town
Round Ireland with a Fridge 
Lost on Planet China: The Strange and True Story of One Man's Attempt to Understand the World's Most Mystifying Nation, or How He Became Comfortable Eating Live Squid
In Patagonia 
A Cook's Tour: Global Adventures in Extreme Cuisines 
Holy Cow: An Indian Adventure
Getting Stoned with Savages: A Trip Through the Islands of Fiji and Vanuatu 
Without Reservations: The Travels of an Independent Woman 
Three Cups of Tea: One Man's Mission to Promote Peace ... One School at a Time
A Year in the World: Journeys of a Passionate Traveller 
The Lost City of Z: A Tale of Deadly Obsession in the Amazon 
Bill Bryson's African Diary
Toujours Provence 
McCarthy's Bar: A Journey of Discovery In Ireland
The Places in Between 
The Old Patagonian Express: By Train Through the Americas 
Ghost Train to the Eastern Star 
Paris to the Moon
My Life in France
The Travel Book: A Journey Through Every Country in the World
Assassination Vacation
Long Way Round: Chasing Shadows Across the World
The Innocents Abroad
Travels in Siberia
Almost French: Love and a New Life in Paris 
Blue Latitudes: Boldly Going Where Captain Cook Has Gone Before 
A Short Walk in the Hindu Kush
Driving Over Lemons: An Optimist in Andalucia 
Turn Right at Machu Picchu: Rediscovering the Lost City One Step at a Time
Happy Isles of Oceania: Paddling the Pacific
Seven Years in Tibet
Last Chance to See
Shadow of the Silk Road
No Touch Monkey!: And Other Travel Lessons Learned Too Late
River Town: Two Years on the Yangtze
French Lessons: Adventures with Knife, Fork, and Corkscrew 
An Embarrassment of Mangoes: A Caribbean Interlude 
Travel as a Political Act

## Self-Help ##
The 7 Habits of Highly Effective People: Powerful Lessons in Personal Change
How to Win Friends and Influence People
Emotional Intelligence 2.0
Who Moved My Cheese 
Men Are from Mars, Women Are from Venus
The Happiness Project: Or Why I Spent a Year Trying to Sing in the Morning, Clean My Closets, Fight Right, Read Aristotle, and Generally Have More Fun
The Four Agreements: A Practical Guide to Personal Freedom 
Getting Things Done: The Art of Stress-Free Productivity 
Don't Sweat the Small Stuff ... and it's all small stuff: Simple Ways to Keep the Little Things from Taking Over Your Life 
How to Stop Worrying and Start Living
The Road Less Traveled: A New Psychology of Love, Traditional Values, and Spiritual Growth
You Can Heal Your Life 
Quiet: The Power of Introverts in a World That Can't Stop Talking
The Power of Habit: Why We Do What We Do in Life and Business
Boundaries: When to Say Yes, How to Say No, to Take Control of Your Life 
Codependent No More: How to Stop Controlling Others and Start Caring for Yourself
Feel the Fear and Do It Anyway 
Feeling Good: The New Mood Therapy
Man's Search for Meaning
The Purpose Driven Life: What on Earth am I Here for? 
The Gifts of Imperfection: Let Go of Who You Think You're Supposed to Be and Embrace Who You Are
The Art of Happiness 
The Highly Sensitive Person 
Switch: How to Change Things When Change Is Hard 
The Now Habit: A Strategic Program for Overcoming Procrastination and Enjoying Guilt-Free Play
The Introvert Advantage: How to Thrive in an Extrovert World 
The Monk Who Sold His Ferrari: A Fable About Fulfilling Your Dreams & Reaching Your Destiny
Women Food and God: An Unexpected Path to Almost Everything
Learned Optimism: How to Change Your Mind and Your Life 
The Power of Intention: Learning to Co-create Your World Your Way